duego: duego
pessoas: pessoas
e: e
de: de
o: o
conheça: conheça
novas: novas
no: no
você: você
mesmo: mesmo
a: a
é: é
para: para
acesse: acesse
gratuito: gratuito
um: um
em: em
agora: agora
moças: moças
que: que
pego: pego
disseram: disseram
da: da
com: com
online: online
se: se
É: É
encontre: encontre
amigos: amigos
do: do
venha: venha
hoje: hoje
basta: basta
conhecer: conhecer
totalmente: totalmente
não: não
clique: clique
são: são
milhares: milhares
sua: sua
divertido: divertido
descubra: descubra
tem: tem
carnaval: carnaval
rio: rio
ao: ao
juntese: juntese
celeb: celeb
ou: ou
cada: cada
seus: seus
amizades: amizades
jogue: jogue
brasília: brasília
pro: pro
na: na
fotos: fotos
novo: novo
redondeza: redondeza
esquina: esquina
curitiba: curitiba
melhor: melhor
todo: todo
descobrir: descobrir
os: os
site: site
nova: nova
campinas: campinas
cidade: cidade
situações: situações
interessantes: interessantes
novos: novos
curtem: curtem
as: as
curtiram: curtiram
mundo: mundo
parece: parece
então: então
floripa: floripa
celebridade: celebridade
twin: twin
porto: porto
alegre: alegre
mesmos: mesmos
uma: uma
lá: lá
monte: monte
parecem: parecem
bh: bh
paulo: paulo
locais: locais
janeiro: janeiro
agito: agito
encontrar: encontrar
hora: hora
perfeita: perfeita
belo: belo
horizonte: horizonte
mais: mais
paquera: paquera
encontra: encontra
vai: vai
qual: qual
fácil: fácil
facebook: facebook
pra: pra
também: também
gente: gente
converse: converse
gratuitamente: gratuitamente
graça: graça
duegocom: duegocom
seu: seu
super: super
divirtase: divirtase
grátis: grátis
social: social
curtir: curtir
garotos: garotos
muita: muita
todos: todos
eles: eles
paquere: paquere
perca: perca
essa: essa
chance: chance
cansou: cansou
capital: capital
pode: pode
gosta: gosta
gatinhas: gatinhas
solteiras: solteiras
combinação: combinação
região: região
dos: dos
compartilhe: compartilhe
cariocas: cariocas
bobeira: bobeira
brasil: brasil
divertidas: divertidas
achou: achou
add: add
ela: ela
interessante: interessante
troque: troque
elas: elas
descobra: descobra
poa: poa
reais: reais
divertir: divertir
jogo: jogo
existe: existe
ideal: ideal
veja: veja
alguém: alguém
rápido: rápido
tá: tá
ninguém: ninguém
pois: pois
te: te
tudo: tudo
perfis: perfis
gatinhos: gatinhos
passa: passa
pega: pega
gatas: gatas
quer: quer
estão: estão
está: está
amar: amar
celebridades: celebridades
iguais: iguais
conversar: conversar
curta: curta
solteiros: solteiros
batepapo: batepapo
só: só
sozinha: sozinha
conhece: conhece
sorriso: sorriso
areia: areia
sozinho: sozinho
garotas: garotas
igual: igual
simplesmente: simplesmente
ele: ele
ideia: ideia
chatas: chatas
seguro: seguro
trilegal: trilegal
talvez: talvez
amigo: amigo
onde: onde
chegou: chegou
este: este
nós: nós
florianópolis: florianópolis
conheca: conheca
rapazes: rapazes
sair: sair
gaúchos: gaúchos
existem: existem
acredite: acredite
cadastrese: cadastrese
recife: recife
vivem: vivem
solta: solta
caminhãozinho: caminhãozinho
véio: véio
buscam: buscam
tchê: tchê
vocês: vocês
enfim: enfim
bemvindo: bemvindo
quem: quem
nego: nego
tempo: tempo
outras: outras
outros: outros
lance: lance
joguinho: joguinho
cansado: cansado
maravilhosa: maravilhosa
encantos: encantos
parecida: parecida
belezas: belezas
ilha: ilha
balada: balada
local: local
princesa: princesa
luciano: luciano
negovéio: negovéio
mas: mas
toda: toda
sp: sp
modo: modo
fala: fala
tipo: tipo
registro: registro
falar: falar
fazer: fazer
moderados: moderados
diz: diz
rede: rede
busca: busca
verão: verão
liga: liga
limpo: limpo
muto: muto
inscrever: inscrever
mistura: mistura
net: net
num: num
quais: quais
amor: amor
amizade: amizade
favorita: favorita
curtindo: curtindo
lembra: lembra
acesso: acesso
alguma: alguma
vão: vão
adorar: adorar
design: design
cool: cool
jogos: jogos
claro: claro
vote: vote
Ótimo: Ótimo
coisas: coisas
supimpa: supimpa
nÃo: nÃo
gosto: gosto
querendo: querendo
gatos: gatos
ambiente: ambiente
aí: aí
ainda: ainda
faça: faça
boa: boa
música: música
deusas: deusas
similares: similares
combina: combina
tão: tão
porque: porque
todas: todas
fofos: fofos
combinam: combinam
comece: comece
dá: dá
tainha: tainha
sempre: sempre
bacana: bacana
ervilhas: ervilhas
saco: saco
experiência: experiência
construa: construa
ideias: ideias
queridas: queridas
apaixonar: apaixonar
queridinhos: queridinhos
pessoa: pessoa
ajude: ajude
essas: essas
coisinhas: coisinhas
achar: achar
apaixonandar: apaixonandar
jogando: jogando
mesmas: mesmas
gostou: gostou
foto: foto
trazer: trazer
vida: vida
divertindo: divertindo
logar: logar
sampa: sampa
jovens: jovens
modernas: modernas
surpreendase: surpreendase
garoa: garoa
bonitos: bonitos
divertidos: divertidos
games: games
sociais: sociais
terra: terra
festa: festa
continua: continua
rolando: rolando
bah: bah
querido: querido
oeste: oeste
trova: trova
gurias: gurias
micareta: micareta
szafir: szafir
doeste: doeste
mineira: mineira
rola: rola
parecidas: parecidas
máfia: máfia
candangos: candangos
momento: momento
ousado: ousado
centenas: centenas
usando: usando
trovando: trovando
nem: nem
nenhum: nenhum
gatinho: gatinho
nenhuma: nenhuma
gata: gata
parecidos: parecidos
especial: especial
adicionou: adicionou
perde: perde
fazenda: fazenda
risco: risco
cara: cara
emcampinas: emcampinas
augusta: augusta
baixa: baixa
lagoa: lagoa
lapa: lapa
festar: festar
lago: lago
internet: internet
sul: sul
ai: ai
perfeito: perfeito
garoto: garoto
dela: dela
eu: eu
garota: garota
sejam: sejam
bemvinda: bemvinda
dele: dele
fanpage: fanpage
sabe: sabe
verdade: verdade
jennifer: jennifer
bradley: bradley
huck: huck
gêmeos: gêmeos
curitibanos: curitibanos
angelina: angelina
kaley: kaley
soltos: soltos
tantos: tantos
exagerar: exagerar
certeza: certeza
exageradas: exageradas
abre: abre
estrela: estrela
concorda: concorda
curte: curte
começar: começar
solteira: solteira
solteiro: solteiro
somos: somos
surpreenda: surpreenda
expanda: expanda
deles: deles
celebs: celebs
tais: tais
universo: universo
juntase: juntase
bloco: bloco
forme: forme
teste: teste
via: via
similaridades: similaridades
esportivo: esportivo
elegante: elegante
têm: têm
conhecendo: conhecendo
famoso: famoso
cansada: cansada
gaudério: gaudério
mate: mate
rendenção: rendenção
conecta: conecta
divertidíssimo: divertidíssimo
aberto: aberto
poder: poder
gostar: gostar
máfiazinha: máfiazinha
papo: papo
bater: bater
conhecidos: conhecidos
salvador: salvador
guris: guris
lindos: lindos
fofinhos: fofinhos
queridíssimos: queridíssimos
adora: adora
dançar: dançar
das: das
nosso: nosso
mensagens: mensagens
fazendinha: fazendinha
usuários: usuários
fazendo: fazendo
vou: vou
banheiro: banheiro
última: última
reta: reta
mesmice: mesmice
passou: passou
